Marca	Xiaomi
Fabricante	Xiaomi
Modelo	Redmi note8 - 64 -Neptune Blue
Nombre del modelo	Redmi Note 8
Model Year	2019
Pilas	1 Polímero de litio necesaria(s), incluida(s)
Número de modelo del producto	Redmi note8 - 64 -Neptune Blue
Número de producto	Redmi note8 - 64 -Neptune Blue
Capacidad de la memoria RAM	4 GB
Capacidad de la memoria	4 GB
Ranuras de memoria disponibles	1
Capacidad de la memoria flash instalada	64 Modificador desconocido
Capacidad de la memoria RAM instalada	4 GB
Capacidad de almacenamiento digital	64 GB
Sistema operativo	Android
Fabricante del procesador	Qualcomm
Velocidad del procesador	2 GHz
Resolución del escáner	1080 x 2340
Otras características	USB, Internet, Camera, Wifi, Flash
Número de productos	1
Tamaño de la pantalla	6.3 Pulgadas
Tipo de pantalla	AMOLED
Resolución máxima	2340 x 1080 Píxeles
Resolución del sensor óptico	48 MP
Pilas / baterías incluidas	Sí
Pilas / baterías necesarias	Sí
Composición de la pila de la batería	Litio Ion
Battery Power Rating	4000 Modificador desconocido
Tecnología GSM	4G
Tipo de conector	Wi-Fi
Entrada de interfaz humana	Pantalla táctil
Factor de forma	Bar
Peso del producto	180 g